Place;Country;Gold;Silver;Bronze;Total;Location;Year
1;UNITED STATES;38;41;34;113;Tokyo;2021
2;China;36;32;18;86;Tokyo;2021
3;Japan;27;12;16;55;Tokyo;2021
4;Britain;22;21;22;65;Tokyo;2021
5;Russia;20;28;23;71;Tokyo;2021
6;Australia;17;7;21;45;Tokyo;2021
7;The Netherlands;10;12;14;36;Tokyo;2021
8;France;10;12;11;33;Tokyo;2021
9;Italy;10;10;20;40;Tokyo;2021
10;Germany;10;10;16;36;Tokyo;2021
11;Canada;7;6;11;24;Tokyo;2021
12;Brazil;7;6;8;21;Tokyo;2021
13;New Zealand;7;6;7;20;Tokyo;2021
14;Cuba;7;3;5;15;Tokyo;2021
15;Hungary;6;7;7;20;Tokyo;2021
16;South Korea;6;4;10;20;Tokyo;2021
17;Poland;4;5;5;14;Tokyo;2021
18;Czech Republic;4;5;3;12;Tokyo;2021
19;Kenya;4;4;2;10;Tokyo;2021
20;Norway;4;2;2;8;Tokyo;2021
21;Jamaica;4;1;4;9;Tokyo;2021
22;Spain;3;8;6;17;Tokyo;2021
23;Sweden;3;6;0;9;Tokyo;2021
24;Swiss;3;4;6;13;Tokyo;2021
25;Denmark;3;4;4;11;Tokyo;2021
26;Croatia;3;3;2;8;Tokyo;2021
27;Iran;3;2;2;7;Tokyo;2021
28;Serbia;3;1;5;9;Tokyo;2021
29;Belgium;3;1;3;7;Tokyo;2021
30;Slovenia;3;1;1;5;Tokyo;2021
31;Uzbekistan;3;0;2;5;Tokyo;2021
32;Georgia;2;5;1;8;Tokyo;2021
33;Taiwan;2;4;6;12;Tokyo;2021
34;Türkiye;2;2;9;13;Tokyo;2021
35;Bulgaria;2;1;2;5;Tokyo;2021
36;Greece;2;1;1;4;Tokyo;2021
36;Uganda;2;1;1;4;Tokyo;2021
38;Ecuador;2;1;0;3;Tokyo;2021
39;Ireland;2;0;2;4;Tokyo;2021
39;Israel;2;0;2;4;Tokyo;2021
41;Latvia;2;0;1;3;Tokyo;2021
41;Qatar;2;0;1;3;Tokyo;2021
43;Bahamas;2;0;0;2;Tokyo;2021
43;Kosovo;2;0;0;2;Tokyo;2021
45;Ukraine;1;6;12;19;Tokyo;2021
46;Belarus;1;3;3;7;Tokyo;2021
47;Romania;1;3;0;4;Tokyo;2021
47;Venezuela;1;3;0;4;Tokyo;2021
49;India;1;2;4;7;Tokyo;2021
50;Hong Kong;1;2;2;5;Tokyo;2021
51;Philippines;1;2;1;4;Tokyo;2021
51;Slovakia;1;2;1;4;Tokyo;2021
53;South Africa;1;2;0;3;Tokyo;2021
54;Austria;1;1;4;6;Tokyo;2021
54;Egypt;1;1;4;6;Tokyo;2021
56;Indonesia;1;1;3;5;Tokyo;2021
57;Ethiopia;1;1;2;4;Tokyo;2021
57;Portugal;1;1;2;4;Tokyo;2021
59;Tunisia;1;1;0;2;Tokyo;2021
60;Estonia;1;0;1;2;Tokyo;2021
60;Fiji;1;0;1;2;Tokyo;2021
60;Thailand;1;0;1;2;Tokyo;2021
63;Bermuda;1;0;0;1;Tokyo;2021
63;Morocco;1;0;0;1;Tokyo;2021
63;Porto Rico;1;0;0;1;Tokyo;2021
66;Colombia;0;4;1;5;Tokyo;2021
67;Azerbaijan;0;3;4;7;Tokyo;2021
68;Dominican Republic;0;3;2;5;Tokyo;2021
69;Armenia;0;2;2;4;Tokyo;2021
70;Kyrgyzstan;0;2;1;3;Tokyo;2021
71;Mongolia;0;1;3;4;Tokyo;2021
72;Argentina;0;1;2;3;Tokyo;2021
72;San Marino;0;1;2;3;Tokyo;2021
74;Jordan;0;1;1;2;Tokyo;2021
74;Malaysia;0;1;1;2;Tokyo;2021
74;Nigeria;0;1;1;2;Tokyo;2021
77;Saudi Arabia;0;1;0;1;Tokyo;2021
77;Bahrain;0;1;0;1;Tokyo;2021
77;Lithuania;0;1;0;1;Tokyo;2021
77;North Macedonia;0;1;0;1;Tokyo;2021
77;Namibia;0;1;0;1;Tokyo;2021
77;Turkmenistan;0;1;0;1;Tokyo;2021
83;Kazakhstan;0;0;8;8;Tokyo;2021
84;Mexico;0;0;4;4;Tokyo;2021
85;Finland;0;0;2;2;Tokyo;2021
86;Botswana;0;0;1;1;Tokyo;2021
86;Burkina Faso;0;0;1;1;Tokyo;2021
86;CIO;0;0;1;1;Tokyo;2021
86;Ivory Coast;0;0;1;1;Tokyo;2021
86;Ghana;0;0;1;1;Tokyo;2021
86;Grenade;0;0;1;1;Tokyo;2021
86;Moldova;0;0;1;1;Tokyo;2021
86;Syria;0;0;1;1;Tokyo;2021
1;UNITED STATES;46;37;38;121;Rio de Janeiro;2016
2;Britain;27;23;17;67;Rio de Janeiro;2016
3;China;26;18;26;70;Rio de Janeiro;2016
4;Russia;19;17;19;55;Rio de Janeiro;2016
5;Germany;17;10;15;42;Rio de Janeiro;2016
6;Japan;12;8;21;41;Rio de Janeiro;2016
7;France;10;18;14;42;Rio de Janeiro;2016
8;South Korea;9;3;9;21;Rio de Janeiro;2016
9;Italy;8;12;8;28;Rio de Janeiro;2016
10;Australia;8;11;10;29;Rio de Janeiro;2016
11;The Netherlands;8;7;4;19;Rio de Janeiro;2016
12;Hungary;8;3;4;15;Rio de Janeiro;2016
13;Brazil;7;6;6;19;Rio de Janeiro;2016
14;Spain;7;4;6;17;Rio de Janeiro;2016
15;Kenya;6;6;1;13;Rio de Janeiro;2016
16;Jamaica;6;3;2;11;Rio de Janeiro;2016
17;Croatia;5;3;2;10;Rio de Janeiro;2016
18;Cuba;5;2;4;11;Rio de Janeiro;2016
19;New Zealand;4;9;5;18;Rio de Janeiro;2016
20;Canada;4;3;15;22;Rio de Janeiro;2016
21;Uzbekistan;4;2;7;13;Rio de Janeiro;2016
22;Kazakhstan;3;5;10;18;Rio de Janeiro;2016
23;Colombia;3;2;3;8;Rio de Janeiro;2016
24;Swiss;3;2;2;7;Rio de Janeiro;2016
25;Iran;3;1;4;8;Rio de Janeiro;2016
26;Greece;3;1;2;6;Rio de Janeiro;2016
27;Argentina;3;1;0;4;Rio de Janeiro;2016
28;Denmark;2;6;7;15;Rio de Janeiro;2016
29;Sweden;2;6;3;11;Rio de Janeiro;2016
30;South Africa;2;6;2;10;Rio de Janeiro;2016
31;Ukraine;2;5;4;11;Rio de Janeiro;2016
32;Serbia;2;4;2;8;Rio de Janeiro;2016
33;Poland;2;3;6;11;Rio de Janeiro;2016
34;North Korea;2;3;2;7;Rio de Janeiro;2016
35;Belgium;2;2;2;6;Rio de Janeiro;2016
35;Thailand;2;2;2;6;Rio de Janeiro;2016
37;Slovakia;2;2;0;4;Rio de Janeiro;2016
38;Georgia;2;1;4;7;Rio de Janeiro;2016
39;Azerbaijan;1;7;10;18;Rio de Janeiro;2016
40;Belarus;1;4;4;9;Rio de Janeiro;2016
41;Türkiye;1;3;4;8;Rio de Janeiro;2016
42;Armenia;1;3;0;4;Rio de Janeiro;2016
43;Czech Republic;1;2;7;10;Rio de Janeiro;2016
44;Ethiopia;1;2;5;8;Rio de Janeiro;2016
45;Slovenia;1;2;1;4;Rio de Janeiro;2016
46;Indonesia;1;2;0;3;Rio de Janeiro;2016
47;Romania;1;1;2;4;Rio de Janeiro;2016
48;Bahrain;1;1;0;2;Rio de Janeiro;2016
48;Vietnam;1;1;0;2;Rio de Janeiro;2016
50;Taiwan;1;0;2;3;Rio de Janeiro;2016
51;Bahamas;1;0;1;2;Rio de Janeiro;2016
51;CIO;1;0;1;2;Rio de Janeiro;2016
51;Ivory Coast;1;0;1;2;Rio de Janeiro;2016
54;Fiji;1;0;0;1;Rio de Janeiro;2016
54;Jordan;1;0;0;1;Rio de Janeiro;2016
54;Kosovo;1;0;0;1;Rio de Janeiro;2016
54;Porto Rico;1;0;0;1;Rio de Janeiro;2016
54;Singapore;1;0;0;1;Rio de Janeiro;2016
54;Tajikistan;1;0;0;1;Rio de Janeiro;2016
60;Malaysia;0;4;1;5;Rio de Janeiro;2016
61;Mexico;0;3;2;5;Rio de Janeiro;2016
62;Algeria;0;2;0;2;Rio de Janeiro;2016
62;Ireland;0;2;0;2;Rio de Janeiro;2016
64;Lithuania;0;1;3;4;Rio de Janeiro;2016
65;Bulgaria;0;1;2;3;Rio de Janeiro;2016
65;Venezuela;0;1;2;3;Rio de Janeiro;2016
67;India;0;1;1;2;Rio de Janeiro;2016
67;Mongolia;0;1;1;2;Rio de Janeiro;2016
69;Burundi;0;1;0;1;Rio de Janeiro;2016
69;Grenade;0;1;0;1;Rio de Janeiro;2016
69;Niger;0;1;0;1;Rio de Janeiro;2016
69;Philippines;0;1;0;1;Rio de Janeiro;2016
69;Qatar;0;1;0;1;Rio de Janeiro;2016
74;Norway;0;0;4;4;Rio de Janeiro;2016
75;Egypt;0;0;3;3;Rio de Janeiro;2016
75;Tunisia;0;0;3;3;Rio de Janeiro;2016
77;Israel;0;0;2;2;Rio de Janeiro;2016
78;Austria;0;0;1;1;Rio de Janeiro;2016
78;United Arab Emirates;0;0;1;1;Rio de Janeiro;2016
78;Estonia;0;0;1;1;Rio de Janeiro;2016
78;Finland;0;0;1;1;Rio de Janeiro;2016
78;Morocco;0;0;1;1;Rio de Janeiro;2016
78;Moldova;0;0;1;1;Rio de Janeiro;2016
78;Nigeria;0;0;1;1;Rio de Janeiro;2016
78;Portugal;0;0;1;1;Rio de Janeiro;2016
78;Dominican Republic;0;0;1;1;Rio de Janeiro;2016
78;Trinidad and Tobago;0;0;1;1;Rio de Janeiro;2016
1;UNITED STATES;46;28;29;103;London;2012
2;China;38;27;24;89;London;2012
3;Britain;29;17;19;65;London;2012
4;Russia;22;19;31;72;London;2012
5;South Korea;13;9;8;30;London;2012
6;Germany;11;20;13;44;London;2012
7;France;11;11;13;35;London;2012
8;Italy;8;9;11;28;London;2012
9;Hungary;8;4;6;18;London;2012
10;Australia;7;16;12;35;London;2012
11;Japan;7;14;17;38;London;2012
12;The Netherlands;6;6;8;20;London;2012
13;Iran;6;5;2;13;London;2012
14;New Zealand;6;2;5;13;London;2012
15;Ukraine;5;4;10;19;London;2012
16;Cuba;5;3;6;14;London;2012
17;Spain;4;10;4;18;London;2012
18;Jamaica;4;5;3;12;London;2012
19;Czech Republic;4;3;3;10;London;2012
20;North Korea;4;0;2;6;London;2012
21;Brazil;3;5;9;17;London;2012
22;Poland;3;2;6;11;London;2012
23;Ethiopia;3;2;2;7;London;2012
24;South Africa;3;2;1;6;London;2012
25;Kazakhstan;3;1;6;10;London;2012
26;Croatia;3;1;2;6;London;2012
27;Canada;2;5;11;18;London;2012
28;Belarus;2;5;3;10;London;2012
29;Kenya;2;4;6;12;London;2012
30;Denmark;2;4;3;9;London;2012
31;Romania;2;4;1;7;London;2012
32;Azerbaijan;2;2;5;9;London;2012
33;Swiss;2;2;0;4;London;2012
34;Lithuania;2;1;2;5;London;2012
35;Norway;2;1;1;4;London;2012
36;Tunisia;2;0;1;3;London;2012
37;Sweden;1;4;3;8;London;2012
38;Colombia;1;3;4;8;London;2012
38;Mexico;1;3;4;8;London;2012
40;Georgia;1;2;3;6;London;2012
41;Ireland;1;1;3;5;London;2012
42;Argentina;1;1;2;4;London;2012
42;Serbia;1;1;2;4;London;2012
42;Slovenia;1;1;2;4;London;2012
42;Trinidad and Tobago;1;1;2;4;London;2012
46;Türkiye;1;1;1;3;London;2012
47;Dominican Republic;1;1;0;2;London;2012
48;Uzbekistan;1;0;3;4;London;2012
49;Latvia;1;0;1;2;London;2012
49;Taiwan;1;0;1;2;London;2012
51;Algeria;1;0;0;1;London;2012
51;Bahamas;1;0;0;1;London;2012
51;Grenade;1;0;0;1;London;2012
51;Uganda;1;0;0;1;London;2012
51;Venezuela;1;0;0;1;London;2012
56;Egypt;0;3;1;4;London;2012
57;India;0;2;4;6;London;2012
58;Mongolia;0;2;3;5;London;2012
59;Thailand;0;2;2;4;London;2012
60;Bulgaria;0;2;1;3;London;2012
61;Slovakia;0;1;3;4;London;2012
62;Belgium;0;1;2;3;London;2012
62;Finland;0;1;2;3;London;2012
62;Indonesia;0;1;2;3;London;2012
65;Armenia;0;1;1;2;London;2012
65;Estonia;0;1;1;2;London;2012
65;Malaysia;0;1;1;2;London;2012
65;Porto Rico;0;1;1;2;London;2012
69;Botswana;0;1;0;1;London;2012
69;Cyprus;0;1;0;1;London;2012
69;Gabon;0;1;0;1;London;2012
69;Guatemala;0;1;0;1;London;2012
69;Montenegro;0;1;0;1;London;2012
69;Portugal;0;1;0;1;London;2012
75;Greece;0;0;2;2;London;2012
75;Qatar;0;0;2;2;London;2012
75;Singapore;0;0;2;2;London;2012
78;Afghanistan;0;0;1;1;London;2012
78;Saudi Arabia;0;0;1;1;London;2012
78;Bahrain;0;0;1;1;London;2012
78;Cameroon;0;0;1;1;London;2012
78;Hong Kong;0;0;1;1;London;2012
78;Morocco;0;0;1;1;London;2012
78;Tajikistan;0;0;1;1;London;2012
78;Vietnam;0;0;1;1;London;2012
1;China;50;22;28;100;Beijing;2008
2;UNITED STATES;36;39;39;114;Beijing;2008
3;Russia;23;15;23;61;Beijing;2008
4;Britain;19;13;18;50;Beijing;2008
5;South Korea;17;13;8;38;Beijing;2008
6;Germany;17;10;15;42;Beijing;2008
7;Australia;15;15;17;47;Beijing;2008
8;Japan;13;6;10;29;Beijing;2008
9;Italy;9;10;10;29;Beijing;2008
10;France;7;18;19;44;Beijing;2008
11;The Netherlands;7;5;8;20;Beijing;2008
12;Ukraine;7;3;13;23;Beijing;2008
13;Kenya;6;4;4;14;Beijing;2008
14;Spain;5;11;3;19;Beijing;2008
15;Jamaica;5;4;1;10;Beijing;2008
16;Poland;4;5;2;11;Beijing;2008
17;Georgia;4;1;3;8;Beijing;2008
17;Romania;4;1;3;8;Beijing;2008
19;Ethiopia;4;1;2;7;Beijing;2008
20;Mexico;4;0;2;6;Beijing;2008
21;Canada;3;10;8;21;Beijing;2008
22;Cuba;3;9;19;31;Beijing;2008
23;Norway;3;6;1;10;Beijing;2008
24;Hungary;3;5;2;10;Beijing;2008
25;Brazil;3;4;13;20;Beijing;2008
26;Belarus;3;3;7;13;Beijing;2008
27;Czech Republic;3;3;0;6;Beijing;2008
28;New Zealand;3;2;4;9;Beijing;2008
29;Slovakia;3;2;1;6;Beijing;2008
30;Mongolia;3;2;0;5;Beijing;2008
31;Thailand;2;3;2;7;Beijing;2008
32;Kazakhstan;2;2;7;11;Beijing;2008
33;Denmark;2;2;3;7;Beijing;2008
34;North Korea;2;2;2;6;Beijing;2008
35;Swiss;2;1;5;8;Beijing;2008
36;Argentina;2;0;5;7;Beijing;2008
37;Iran;2;0;1;3;Beijing;2008
38;Belgium;2;0;0;2;Beijing;2008
39;Zimbabwe;1;3;0;4;Beijing;2008
40;Türkiye;1;2;4;7;Beijing;2008
41;Slovenia;1;2;3;6;Beijing;2008
42;Dominican Republic;1;2;0;3;Beijing;2008
43;Azerbaijan;1;1;4;6;Beijing;2008
43;Indonesia;1;1;4;6;Beijing;2008
43;Taiwan;1;1;4;6;Beijing;2008
46;Bulgaria;1;1;3;5;Beijing;2008
47;Finland;1;1;2;4;Beijing;2008
48;Latvia;1;1;1;3;Beijing;2008
49;Estonia;1;1;0;2;Beijing;2008
49;Portugal;1;1;0;2;Beijing;2008
51;India;1;0;2;3;Beijing;2008
52;Cameroon;1;0;0;1;Beijing;2008
52;Panama;1;0;0;1;Beijing;2008
52;Tunisia;1;0;0;1;Beijing;2008
55;Sweden;0;4;1;5;Beijing;2008
56;Greece;0;3;1;4;Beijing;2008
57;Croatia;0;2;5;7;Beijing;2008
58;Nigeria;0;2;4;6;Beijing;2008
59;Lithuania;0;2;3;5;Beijing;2008
60;Austria;0;2;2;4;Beijing;2008
61;Colombia;0;2;1;3;Beijing;2008
62;Trinidad and Tobago;0;2;0;2;Beijing;2008
63;Armenia;0;1;4;5;Beijing;2008
63;Uzbekistan;0;1;4;5;Beijing;2008
65;Ireland;0;1;2;3;Beijing;2008
65;Serbia;0;1;2;3;Beijing;2008
67;Algeria;0;1;1;2;Beijing;2008
67;Bahamas;0;1;1;2;Beijing;2008
67;Kyrgyzstan;0;1;1;2;Beijing;2008
67;Morocco;0;1;1;2;Beijing;2008
67;Tajikistan;0;1;1;2;Beijing;2008
72;South Africa;0;1;0;1;Beijing;2008
72;Chile;0;1;0;1;Beijing;2008
72;Ecuador;0;1;0;1;Beijing;2008
72;Iceland;0;1;0;1;Beijing;2008
72;Malaysia;0;1;0;1;Beijing;2008
72;Samoa;0;1;0;1;Beijing;2008
72;Singapore;0;1;0;1;Beijing;2008
72;Sudan;0;1;0;1;Beijing;2008
72;Vietnam;0;1;0;1;Beijing;2008
81;Egypt;0;0;3;3;Beijing;2008
82;Afghanistan;0;0;2;2;Beijing;2008
82;Venezuela;0;0;2;2;Beijing;2008
84;MAURITIUS;0;0;1;1;Beijing;2008
84;Israel;0;0;1;1;Beijing;2008
84;Moldova;0;0;1;1;Beijing;2008
84;Togo;0;0;1;1;Beijing;2008
1;UNITED STATES;36;40;27;103;Athens;2004
2;China;34;17;14;65;Athens;2004
3;Russia;28;27;36;91;Athens;2004
4;Australia;17;16;17;50;Athens;2004
5;Japan;16;9;12;37;Athens;2004
6;Germany;13;16;20;49;Athens;2004
7;France;11;9;14;34;Athens;2004
8;Italy;10;11;11;32;Athens;2004
9;South Korea;9;12;11;32;Athens;2004
10;Britain;9;9;12;30;Athens;2004
11;Cuba;9;8;11;28;Athens;2004
12;Hungary;8;6;3;17;Athens;2004
13;Ukraine;8;5;9;22;Athens;2004
14;Romania;8;5;6;19;Athens;2004
15;Greece;6;8;4;18;Athens;2004
16;Brazil;5;2;3;10;Athens;2004
17;Norway;5;0;1;6;Athens;2004
18;The Netherlands;4;9;9;22;Athens;2004
19;Sweden;4;2;1;7;Athens;2004
19;Taiwan;4;2;1;7;Athens;2004
21;Spain;3;11;5;19;Athens;2004
22;Canada;3;6;3;12;Athens;2004
23;Türkiye;3;4;5;12;Athens;2004
24;Poland;3;2;5;10;Athens;2004
25;Iran;3;2;2;7;Athens;2004
26;New Zealand;3;2;0;5;Athens;2004
27;Thailand;3;1;5;9;Athens;2004
28;Belarus;2;5;5;12;Athens;2004
29;Austria;2;4;1;7;Athens;2004
30;Ethiopia;2;3;2;7;Athens;2004
31;Slovakia;2;2;2;6;Athens;2004
32;Georgia;2;2;0;4;Athens;2004
33;Bulgaria;2;1;10;13;Athens;2004
34;Jamaica;2;1;2;5;Athens;2004
35;Morocco;2;1;0;3;Athens;2004
36;Denmark;2;0;6;8;Athens;2004
37;Argentina;2;0;4;6;Athens;2004
38;Uzbekistan;2;0;2;4;Athens;2004
39;Chile;2;0;1;3;Athens;2004
40;Kazakhstan;1;4;4;9;Athens;2004
41;Kenya;1;4;2;7;Athens;2004
42;Czech Republic;1;3;4;8;Athens;2004
43;South Africa;1;3;2;6;Athens;2004
44;Croatia;1;2;1;4;Athens;2004
45;Lithuania;1;2;0;3;Athens;2004
46;Egypt;1;1;4;6;Athens;2004
47;Swiss;1;1;3;5;Athens;2004
48;Indonesia;1;1;2;4;Athens;2004
49;Zimbabwe;1;1;1;3;Athens;2004
50;Azerbaijan;1;0;4;5;Athens;2004
51;Belgium;1;0;2;3;Athens;2004
52;Bahamas;1;0;1;2;Athens;2004
52;Israel;1;0;1;2;Athens;2004
54;Cameroon;1;0;0;1;Athens;2004
54;United Arab Emirates;1;0;0;1;Athens;2004
54;Dominican Republic;1;0;0;1;Athens;2004
57;North Korea;0;4;1;5;Athens;2004
58;Latvia;0;4;0;4;Athens;2004
59;Mexico;0;3;2;5;Athens;2004
60;Portugal;0;2;1;3;Athens;2004
61;Finland;0;2;0;2;Athens;2004
61;Serbia;0;2;0;2;Athens;2004
63;Slovenia;0;1;3;4;Athens;2004
64;Estonia;0;1;2;3;Athens;2004
65;Hong Kong;0;1;0;1;Athens;2004
65;India;0;1;0;1;Athens;2004
65;Paraguay;0;1;0;1;Athens;2004
68;Venezuela;0;0;3;3;Athens;2004
69;Nigeria;0;0;2;2;Athens;2004
70;Colombia;0;0;1;1;Athens;2004
70;Eritrea;0;0;1;1;Athens;2004
70;Mongolia;0;0;1;1;Athens;2004
70;Syria;0;0;1;1;Athens;2004
70;Trinidad and Tobago;0;0;1;1;Athens;2004
1;UNITED STATES;37;24;32;93;Sydney;2000
2;Russia;32;27;29;88;Sydney;2000
3;China;28;16;14;58;Sydney;2000
4;Australia;16;25;17;58;Sydney;2000
5;Germany;13;17;26;56;Sydney;2000
6;France;13;14;11;38;Sydney;2000
7;Italy;13;8;13;34;Sydney;2000
8;The Netherlands;12;9;4;25;Sydney;2000
9;Cuba;11;11;7;29;Sydney;2000
10;Britain;11;10;7;28;Sydney;2000
11;Romania;11;6;9;26;Sydney;2000
12;South Korea;8;10;10;28;Sydney;2000
13;Hungary;8;6;3;17;Sydney;2000
14;Poland;6;5;3;14;Sydney;2000
15;Japan;5;8;5;18;Sydney;2000
16;Bulgaria;5;6;2;13;Sydney;2000
17;Greece;4;6;3;13;Sydney;2000
17;Sweden;4;6;3;13;Sydney;2000
19;Norway;4;3;3;10;Sydney;2000
20;Ethiopia;4;1;3;8;Sydney;2000
21;Ukraine;3;10;10;23;Sydney;2000
22;Kazakhstan;3;4;1;8;Sydney;2000
23;Belarus;3;3;10;16;Sydney;2000
24;Canada;3;3;8;14;Sydney;2000
25;Spain;3;3;5;11;Sydney;2000
26;Türkiye;3;0;2;5;Sydney;2000
27;Iran;3;0;1;4;Sydney;2000
28;Czech Republic;2;3;3;8;Sydney;2000
29;Denmark;2;3;1;6;Sydney;2000
30;Kenya;2;2;2;6;Sydney;2000
31;Finland;2;1;1;4;Sydney;2000
32;Austria;2;1;0;3;Sydney;2000
33;Lithuania;2;0;3;5;Sydney;2000
34;Azerbaijan;2;0;1;3;Sydney;2000
34;Bahamas;2;0;1;3;Sydney;2000
36;Slovenia;2;0;0;2;Sydney;2000
37;Swiss;1;6;2;9;Sydney;2000
38;Indonesia;1;3;2;6;Sydney;2000
39;Slovakia;1;3;1;5;Sydney;2000
40;Mexico;1;2;3;6;Sydney;2000
41;Nigeria;1;2;0;3;Sydney;2000
42;Algeria;1;1;3;5;Sydney;2000
43;Uzbekistan;1;1;2;4;Sydney;2000
44;Latvia;1;1;1;3;Sydney;2000
44;Yugoslavia;1;1;1;3;Sydney;2000
46;New Zealand;1;0;3;4;Sydney;2000
47;Estonia;1;0;2;3;Sydney;2000
47;Thailand;1;0;2;3;Sydney;2000
49;Croatia;1;0;1;2;Sydney;2000
50;Cameroon;1;0;0;1;Sydney;2000
50;Colombia;1;0;0;1;Sydney;2000
50;Mozambique;1;0;0;1;Sydney;2000
53;Brazil;0;6;6;12;Sydney;2000
54;Jamaica;0;6;3;9;Sydney;2000
55;South Africa;0;2;3;5;Sydney;2000
55;Belgium;0;2;3;5;Sydney;2000
57;Argentina;0;2;2;4;Sydney;2000
58;Morocco;0;1;4;5;Sydney;2000
58;Taiwan;0;1;4;5;Sydney;2000
60;North Korea;0;1;3;4;Sydney;2000
61;Saudi Arabia;0;1;1;2;Sydney;2000
61;Moldova;0;1;1;2;Sydney;2000
61;Trinidad and Tobago;0;1;1;2;Sydney;2000
64;Ireland;0;1;0;1;Sydney;2000
64;Sri Lanka;0;1;0;1;Sydney;2000
64;Uruguay;0;1;0;1;Sydney;2000
64;Vietnam;0;1;0;1;Sydney;2000
68;Georgia;0;0;6;6;Sydney;2000
69;Costa Rica;0;0;2;2;Sydney;2000
69;Portugal;0;0;2;2;Sydney;2000
71;Armenia;0;0;1;1;Sydney;2000
71;Barbados;0;0;1;1;Sydney;2000
71;Chile;0;0;1;1;Sydney;2000
71;India;0;0;1;1;Sydney;2000
71;Iceland;0;0;1;1;Sydney;2000
71;Israel;0;0;1;1;Sydney;2000
71;Kyrgyzstan;0;0;1;1;Sydney;2000
71;Kuwait;0;0;1;1;Sydney;2000
71;North Macedonia;0;0;1;1;Sydney;2000
71;Qatar;0;0;1;1;Sydney;2000
1;UNITED STATES;44;33;25;102;Atlanta;1996
2;Russia;26;21;15;62;Atlanta;1996
3;Germany;19;18;27;64;Atlanta;1996
4;China;16;21;11;48;Atlanta;1996
5;France;15;8;15;38;Atlanta;1996
6;Italy;13;10;12;35;Atlanta;1996
7;Australia;9;9;23;41;Atlanta;1996
8;Cuba;9;7;8;24;Atlanta;1996
9;Ukraine;9;2;13;24;Atlanta;1996
10;South Korea;7;15;5;27;Atlanta;1996
11;Poland;7;5;5;17;Atlanta;1996
12;Hungary;7;4;9;20;Atlanta;1996
13;Spain;5;6;6;17;Atlanta;1996
14;Romania;4;7;10;21;Atlanta;1996
15;The Netherlands;4;5;10;19;Atlanta;1996
16;Greece;4;4;0;8;Atlanta;1996
17;Czech Republic;4;3;4;11;Atlanta;1996
18;Swiss;4;3;0;7;Atlanta;1996
19;Denmark;4;1;1;6;Atlanta;1996
19;Türkiye;4;1;1;6;Atlanta;1996
21;Canada;3;11;8;22;Atlanta;1996
22;Bulgaria;3;7;5;15;Atlanta;1996
23;Japan;3;6;5;14;Atlanta;1996
24;Kazakhstan;3;4;4;11;Atlanta;1996
25;Brazil;3;3;9;15;Atlanta;1996
26;New Zealand;3;2;1;6;Atlanta;1996
27;South Africa;3;1;1;5;Atlanta;1996
28;Ireland;3;0;1;4;Atlanta;1996
29;Sweden;2;4;3;9;Atlanta;1996
30;Norway;2;2;3;7;Atlanta;1996
31;Belgium;2;2;2;6;Atlanta;1996
32;Nigeria;2;1;3;6;Atlanta;1996
33;North Korea;2;1;2;5;Atlanta;1996
34;Algeria;2;0;1;3;Atlanta;1996
34;Ethiopia;2;0;1;3;Atlanta;1996
36;Britain;1;8;6;15;Atlanta;1996
37;Belarus;1;6;8;15;Atlanta;1996
38;Kenya;1;4;2;7;Atlanta;1996
39;Jamaica;1;3;2;6;Atlanta;1996
40;Finland;1;2;1;4;Atlanta;1996
41;Indonesia;1;1;2;4;Atlanta;1996
41;Yugoslavia;1;1;2;4;Atlanta;1996
43;Iran;1;1;1;3;Atlanta;1996
43;Slovakia;1;1;1;3;Atlanta;1996
45;Armenia;1;1;0;2;Atlanta;1996
45;Croatia;1;1;0;2;Atlanta;1996
47;Thailand;1;0;2;3;Atlanta;1996
48;Porto Rico;1;0;1;2;Atlanta;1996
48;Portugal;1;0;1;2;Atlanta;1996
50;Burundi;1;0;0;1;Atlanta;1996
50;Costa Rica;1;0;0;1;Atlanta;1996
50;Ecuador;1;0;0;1;Atlanta;1996
50;Hong Kong;1;0;0;1;Atlanta;1996
50;Syria;1;0;0;1;Atlanta;1996
55;Argentina;0;2;1;3;Atlanta;1996
56;Namibia;0;2;0;2;Atlanta;1996
56;Slovenia;0;2;0;2;Atlanta;1996
58;Austria;0;1;2;3;Atlanta;1996
59;Malaysia;0;1;1;2;Atlanta;1996
59;Moldova;0;1;1;2;Atlanta;1996
59;Uzbekistan;0;1;1;2;Atlanta;1996
62;Azerbaijan;0;1;0;1;Atlanta;1996
62;Bahamas;0;1;0;1;Atlanta;1996
62;Latvia;0;1;0;1;Atlanta;1996
62;Philippines;0;1;0;1;Atlanta;1996
62;Taiwan;0;1;0;1;Atlanta;1996
62;Tonga;0;1;0;1;Atlanta;1996
62;Zambia;0;1;0;1;Atlanta;1996
69;Georgia;0;0;2;2;Atlanta;1996
69;Morocco;0;0;2;2;Atlanta;1996
69;Trinidad and Tobago;0;0;2;2;Atlanta;1996
72;India;0;0;1;1;Atlanta;1996
72;Israel;0;0;1;1;Atlanta;1996
72;Lithuania;0;0;1;1;Atlanta;1996
72;Mexico;0;0;1;1;Atlanta;1996
72;Mongolia;0;0;1;1;Atlanta;1996
72;Mozambique;0;0;1;1;Atlanta;1996
72;Uganda;0;0;1;1;Atlanta;1996
72;Tunisia;0;0;1;1;Atlanta;1996
1;Commonwealth of Independent States;45;38;29;112;Barcelona;1992
2;UNITED STATES;36;34;37;107;Barcelona;1992
3;Germany;34;20;29;83;Barcelona;1992
5;China;16;21;15;52;Barcelona;1992
6;Cuba;14;6;11;31;Barcelona;1992
7;Spain;13;7;2;22;Barcelona;1992
9;South Korea;12;5;11;28;Barcelona;1992
10;Hungary;11;12;8;31;Barcelona;1992
12;France;8;5;16;29;Barcelona;1992
14;Australia;7;9;11;27;Barcelona;1992
16;Canada;7;4;7;18;Barcelona;1992
17;Italy;5;6;8;19;Barcelona;1992
19;Britain;5;3;12;20;Barcelona;1992
21;Romania;4;6;7;17;Barcelona;1992
22;Czechoslovakia;4;2;1;7;Barcelona;1992
23;North Korea;4;0;5;9;Barcelona;1992
24;Japan;3;8;11;22;Barcelona;1992
25;Bulgaria;3;7;6;16;Barcelona;1992
26;Poland;3;6;10;19;Barcelona;1992
27;The Netherlands;2;6;7;15;Barcelona;1992
28;Kenya;2;4;2;8;Barcelona;1992
29;Norway;2;4;1;7;Barcelona;1992
30;Türkiye;2;2;2;6;Barcelona;1992
31;Indonesia;2;2;1;5;Barcelona;1992
32;Brazil;2;1;0;3;Barcelona;1992
33;Greece;2;0;0;2;Barcelona;1992
34;Sweden;1;7;4;12;Barcelona;1992
35;New Zealand;1;4;5;10;Barcelona;1992
36;Finland;1;2;2;5;Barcelona;1992
37;Denmark;1;1;4;6;Barcelona;1992
38;Morocco;1;1;1;3;Barcelona;1992
39;Ireland;1;1;0;2;Barcelona;1992
40;Ethiopia;1;0;2;3;Barcelona;1992
41;Algeria;1;0;1;2;Barcelona;1992
41;Lithuania;1;0;1;2;Barcelona;1992
41;Porto Rico;1;0;1;2;Barcelona;1992
44;Swiss;1;0;0;1;Barcelona;1992
46;Jamaica;0;3;1;4;Barcelona;1992
46;Nigeria;0;3;1;4;Barcelona;1992
48;Latvia;0;2;1;3;Barcelona;1992
49;South Africa;0;2;0;2;Barcelona;1992
49;Austria;0;2;0;2;Barcelona;1992
49;Namibia;0;2;0;2;Barcelona;1992
53;Belgium;0;1;2;3;Barcelona;1992
53;Croatia;0;1;2;3;Barcelona;1992
53;International;0;1;2;3;Barcelona;1992
53;Iran;0;1;2;3;Barcelona;1992
58;Israel;0;1;1;2;Barcelona;1992
58;Thailand;0;1;1;2;Barcelona;1992
60;Mexico;0;1;0;1;Barcelona;1992
60;Peru;0;1;0;1;Barcelona;1992
60;Taiwan;0;1;0;1;Barcelona;1992
63;Slovenia;0;0;2;2;Barcelona;1992
64;Argentina;0;0;1;1;Barcelona;1992
64;Bahamas;0;0;1;1;Barcelona;1992
64;Colombia;0;0;1;1;Barcelona;1992
64;Commonwealth of Independent States;0;0;1;1;Barcelona;1992
64;Estonia;0;0;1;1;Barcelona;1992
64;Ghana;0;0;1;1;Barcelona;1992
64;Malaysia;0;0;1;1;Barcelona;1992
64;Mongolia;0;0;1;1;Barcelona;1992
64;Pakistan;0;0;1;1;Barcelona;1992
64;Philippines;0;0;1;1;Barcelona;1992
64;Qatar;0;0;1;1;Barcelona;1992
64;Suriname;0;0;1;1;Barcelona;1992
1;U.S.S.R.;51;32;44;127;Seoul;1988
2;East Germany;37;34;31;102;Seoul;1988
3;UNITED STATES;36;31;27;94;Seoul;1988
4;South Korea;12;10;11;33;Seoul;1988
5;Hungary;11;6;6;23;Seoul;1988
6;West Germany;10;14;13;37;Seoul;1988
7;Bulgaria;10;12;13;35;Seoul;1988
8;Romania;7;11;6;24;Seoul;1988
9;France;6;4;6;16;Seoul;1988
10;Italy;6;4;4;14;Seoul;1988
11;China;5;11;12;28;Seoul;1988
12;Britain;5;10;9;24;Seoul;1988
13;Kenya;5;2;2;9;Seoul;1988
14;Japan;4;3;8;15;Seoul;1988
15;Australia;3;6;4;13;Seoul;1988
16;Czechoslovakia;3;3;2;8;Seoul;1988
17;New Zealand;3;2;8;13;Seoul;1988
18;Canada;3;2;5;10;Seoul;1988
19;Poland;2;5;9;16;Seoul;1988
20;Norway;2;3;0;5;Seoul;1988
21;The Netherlands;2;2;5;9;Seoul;1988
22;Denmark;2;1;1;4;Seoul;1988
23;Commonwealth of Independent States;2;0;2;4;Seoul;1988
24;Germany;2;0;1;3;Seoul;1988
24;Serbia;2;0;1;3;Seoul;1988
26;Yugoslavia;1;4;4;9;Seoul;1988
27;Brazil;1;2;3;6;Seoul;1988
28;Spain;1;1;2;4;Seoul;1988
28;Finland;1;1;2;4;Seoul;1988
30;Türkiye;1;1;0;2;Seoul;1988
31;Morocco;1;0;2;3;Seoul;1988
32;Austria;1;0;0;1;Seoul;1988
32;Portugal;1;0;0;1;Seoul;1988
32;Suriname;1;0;0;1;Seoul;1988
35;Sweden;0;4;7;11;Seoul;1988
36;Swiss;0;2;2;4;Seoul;1988
37;Jamaica;0;2;0;2;Seoul;1988
38;Argentina;0;1;1;2;Seoul;1988
39;Netherlands Antilles;0;1;0;1;Seoul;1988
39;Chile;0;1;0;1;Seoul;1988
39;Costa Rica;0;1;0;1;Seoul;1988
39;US Virgin Islands;0;1;0;1;Seoul;1988
39;Indonesia;0;1;0;1;Seoul;1988
39;Iran;0;1;0;1;Seoul;1988
39;Peru;0;1;0;1;Seoul;1988
39;Senegal;0;1;0;1;Seoul;1988
47;Belgium;0;0;2;2;Seoul;1988
47;Mexico;0;0;2;2;Seoul;1988
49;Colombia;0;0;1;1;Seoul;1988
49;Djibouti;0;0;1;1;Seoul;1988
49;Greece;0;0;1;1;Seoul;1988
49;Mongolia;0;0;1;1;Seoul;1988
49;Pakistan;0;0;1;1;Seoul;1988
49;Philippines;0;0;1;1;Seoul;1988
49;Thailand;0;0;1;1;Seoul;1988
1;UNITED STATES;83;62;29;174;Los Angeles;1984
2;Romania;20;16;17;53;Los Angeles;1984
3;West Germany;17;19;22;58;Los Angeles;1984
4;China;14;8;9;31;Los Angeles;1984
5;Italy;14;6;11;31;Los Angeles;1984
6;Canada;11;18;16;45;Los Angeles;1984
7;Japan;10;8;14;32;Los Angeles;1984
8;New Zealand;8;1;2;11;Los Angeles;1984
9;Yugoslavia;7;4;7;18;Los Angeles;1984
10;South Korea;6;6;7;19;Los Angeles;1984
11;Britain;5;11;21;37;Los Angeles;1984
12;France;5;7;16;28;Los Angeles;1984
13;The Netherlands;5;2;6;13;Los Angeles;1984
14;Australia;4;8;12;24;Los Angeles;1984
15;Finland;4;2;6;12;Los Angeles;1984
16;Sweden;2;10;6;18;Los Angeles;1984
17;Morocco;2;0;0;2;Los Angeles;1984
18;Brazil;1;5;2;8;Los Angeles;1984
19;Mexico;1;3;1;5;Los Angeles;1984
20;Spain;1;2;2;5;Los Angeles;1984
21;Belgium;1;1;2;4;Los Angeles;1984
22;Austria;1;1;1;3;Los Angeles;1984
23;Kenya;1;0;2;3;Los Angeles;1984
23;Portugal;1;0;2;3;Los Angeles;1984
25;Pakistan;1;0;0;1;Los Angeles;1984
25;U.S.S.R.;1;0;0;1;Los Angeles;1984
27;Swiss;0;4;4;8;Los Angeles;1984
28;Denmark;0;3;3;6;Los Angeles;1984
29;Jamaica;0;1;2;3;Los Angeles;1984
29;Norway;0;1;2;3;Los Angeles;1984
31;East Germany;0;1;1;2;Los Angeles;1984
31;Greece;0;1;1;2;Los Angeles;1984
31;Nigeria;0;1;1;2;Los Angeles;1984
31;Porto Rico;0;1;1;2;Los Angeles;1984
35;Colombia;0;1;0;1;Los Angeles;1984
35;Ivory Coast;0;1;0;1;Los Angeles;1984
35;Egypt;0;1;0;1;Los Angeles;1984
35;Ireland;0;1;0;1;Los Angeles;1984
35;Peru;0;1;0;1;Los Angeles;1984
35;Syria;0;1;0;1;Los Angeles;1984
35;Thailand;0;1;0;1;Los Angeles;1984
42;Türkiye;0;0;3;3;Los Angeles;1984
42;Venezuela;0;0;3;3;Los Angeles;1984
44;Algeria;0;0;2;2;Los Angeles;1984
45;Germany;0;0;1;1;Los Angeles;1984
45;Cameroon;0;0;1;1;Los Angeles;1984
45;Iceland;0;0;1;1;Los Angeles;1984
45;Dominican Republic;0;0;1;1;Los Angeles;1984
45;Taiwan;0;0;1;1;Los Angeles;1984
45;Zambia;0;0;1;1;Los Angeles;1984
1;U.S.S.R.;80;68;46;194;Moscow;1980
2;East Germany;47;37;42;126;Moscow;1980
3;Bulgaria;8;16;17;41;Moscow;1980
4;Cuba;8;7;5;20;Moscow;1980
5;Italy;8;3;4;15;Moscow;1980
6;Hungary;7;10;15;32;Moscow;1980
7;Romania;6;6;13;25;Moscow;1980
8;France;6;5;3;14;Moscow;1980
9;Britain;5;7;9;21;Moscow;1980
10;Poland;3;14;15;32;Moscow;1980
11;Sweden;3;3;6;12;Moscow;1980
12;Finland;3;1;4;8;Moscow;1980
13;Czechoslovakia;2;3;9;14;Moscow;1980
14;Yugoslavia;2;3;4;9;Moscow;1980
15;Australia;2;2;5;9;Moscow;1980
16;Denmark;2;1;2;5;Moscow;1980
17;Brazil;2;0;2;4;Moscow;1980
17;Ethiopia;2;0;2;4;Moscow;1980
19;Swiss;2;0;0;2;Moscow;1980
20;Spain;1;3;2;6;Moscow;1980
21;Austria;1;2;1;4;Moscow;1980
22;Greece;1;0;2;3;Moscow;1980
23;Belgium;1;0;0;1;Moscow;1980
23;India;1;0;0;1;Moscow;1980
23;Zimbabwe;1;0;0;1;Moscow;1980
26;North Korea;0;3;2;5;Moscow;1980
27;Mongolia;0;2;2;4;Moscow;1980
28;Tanzania;0;2;0;2;Moscow;1980
29;Mexico;0;1;3;4;Moscow;1980
30;The Netherlands;0;1;2;3;Moscow;1980
31;Ireland;0;1;1;2;Moscow;1980
32;Germany;0;1;0;1;Moscow;1980
32;Uganda;0;1;0;1;Moscow;1980
32;Venezuela;0;1;0;1;Moscow;1980
35;Jamaica;0;0;3;3;Moscow;1980
36;Guyana;0;0;1;1;Moscow;1980
36;Lebanon;0;0;1;1;Moscow;1980
1;U.S.S.R.;48;41;35;124;Montreal;1976
2;East Germany;40;25;25;90;Montreal;1976
3;UNITED STATES;34;36;26;96;Montreal;1976
4;West Germany;10;12;17;39;Montreal;1976
5;Japan;9;5;9;23;Montreal;1976
6;Poland;7;6;13;26;Montreal;1976
7;Bulgaria;6;9;7;22;Montreal;1976
8;Cuba;6;4;3;13;Montreal;1976
9;Romania;4;9;14;27;Montreal;1976
10;Hungary;4;5;13;22;Montreal;1976
11;Finland;4;2;0;6;Montreal;1976
12;Sweden;4;1;0;5;Montreal;1976
13;Britain;3;5;5;13;Montreal;1976
14;Italy;2;7;4;13;Montreal;1976
15;France;2;3;4;9;Montreal;1976
16;Yugoslavia;2;3;3;8;Montreal;1976
17;Czechoslovakia;2;2;4;8;Montreal;1976
18;Swiss;2;1;2;5;Montreal;1976
19;New Zealand;2;1;1;4;Montreal;1976
20;South Korea;1;1;4;6;Montreal;1976
21;North Korea;1;1;0;2;Montreal;1976
21;Jamaica;1;1;0;2;Montreal;1976
21;Norway;1;1;0;2;Montreal;1976
24;Denmark;1;0;2;3;Montreal;1976
25;Mexico;1;0;1;2;Montreal;1976
26;Trinidad and Tobago;1;0;0;1;Montreal;1976
27;Canada;0;5;7;12;Montreal;1976
28;Belgium;0;3;3;6;Montreal;1976
29;The Netherlands;0;2;3;5;Montreal;1976
30;Spain;0;2;0;2;Montreal;1976
30;Portugal;0;2;0;2;Montreal;1976
32;Australia;0;1;3;4;Montreal;1976
33;Iran;0;1;1;2;Montreal;1976
34;Mongolia;0;1;0;1;Montreal;1976
34;Venezuela;0;1;0;1;Montreal;1976
36;Brazil;0;0;2;2;Montreal;1976
37;Austria;0;0;1;1;Montreal;1976
37;Bermuda;0;0;1;1;Montreal;1976
37;Pakistan;0;0;1;1;Montreal;1976
37;Porto Rico;0;0;1;1;Montreal;1976
37;Thailand;0;0;1;1;Montreal;1976
1;U.S.S.R.;50;27;22;99;Munich;1972
2;UNITED STATES;33;31;29;93;Munich;1972
3;East Germany;20;23;22;65;Munich;1972
4;West Germany;13;11;15;39;Munich;1972
5;Japan;13;8;8;29;Munich;1972
6;Australia;8;7;2;17;Munich;1972
7;Poland;7;5;9;21;Munich;1972
8;Hungary;6;13;16;35;Munich;1972
9;Bulgaria;6;10;5;21;Munich;1972
10;Italy;5;3;10;18;Munich;1972
11;Sweden;4;6;6;16;Munich;1972
12;Britain;4;5;8;17;Munich;1972
13;Romania;3;6;6;15;Munich;1972
14;Cuba;3;1;4;8;Munich;1972
14;Finland;3;1;4;8;Munich;1972
16;The Netherlands;3;1;1;5;Munich;1972
17;France;2;4;8;14;Munich;1972
18;Czechoslovakia;2;4;2;8;Munich;1972
19;Kenya;2;3;4;9;Munich;1972
20;Yugoslavia;2;1;2;5;Munich;1972
21;Norway;2;1;1;4;Munich;1972
22;North Korea;1;1;3;5;Munich;1972
23;New Zealand;1;1;1;3;Munich;1972
24;Uganda;1;1;0;2;Munich;1972
25;Denmark;1;0;0;1;Munich;1972
26;Swiss;0;3;0;3;Munich;1972
27;Canada;0;2;3;5;Munich;1972
28;Iran;0;2;1;3;Munich;1972
29;Belgium;0;2;0;2;Munich;1972
29;Greece;0;2;0;2;Munich;1972
31;Austria;0;1;2;3;Munich;1972
31;Colombia;0;1;2;3;Munich;1972
33;Argentina;0;1;0;1;Munich;1972
33;South Korea;0;1;0;1;Munich;1972
33;Lebanon;0;1;0;1;Munich;1972
33;Mexico;0;1;0;1;Munich;1972
33;Mongolia;0;1;0;1;Munich;1972
33;Pakistan;0;1;0;1;Munich;1972
33;Tunisia;0;1;0;1;Munich;1972
33;Türkiye;0;1;0;1;Munich;1972
41;Germany;0;0;3;3;Munich;1972
42;Brazil;0;0;2;2;Munich;1972
42;Ethiopia;0;0;2;2;Munich;1972
44;Spain;0;0;1;1;Munich;1972
44;Ghana;0;0;1;1;Munich;1972
44;India;0;0;1;1;Munich;1972
44;Jamaica;0;0;1;1;Munich;1972
44;Moldova;0;0;1;1;Munich;1972
44;Niger;0;0;1;1;Munich;1972
44;Nigeria;0;0;1;1;Munich;1972
1;UNITED STATES;45;28;34;107;Mexico;1968
2;U.S.S.R.;29;32;30;91;Mexico;1968
3;Japan;11;7;7;25;Mexico;1968
4;Hungary;10;10;12;32;Mexico;1968
5;East Germany;9;9;7;25;Mexico;1968
6;France;7;3;5;15;Mexico;1968
7;Czechoslovakia;7;2;4;13;Mexico;1968
8;West Germany;5;11;10;26;Mexico;1968
9;Australia;5;7;5;17;Mexico;1968
10;Britain;5;5;3;13;Mexico;1968
11;Poland;5;2;11;18;Mexico;1968
12;Romania;4;6;5;15;Mexico;1968
13;Italy;3;4;9;16;Mexico;1968
14;Kenya;3;4;2;9;Mexico;1968
15;Mexico;3;3;3;9;Mexico;1968
16;Yugoslavia;3;3;2;8;Mexico;1968
17;The Netherlands;3;3;1;7;Mexico;1968
18;Bulgaria;2;4;3;9;Mexico;1968
19;Iran;2;1;2;5;Mexico;1968
20;Sweden;2;1;1;4;Mexico;1968
21;Türkiye;2;0;0;2;Mexico;1968
22;Denmark;1;4;3;8;Mexico;1968
23;Canada;1;3;1;5;Mexico;1968
24;Finland;1;2;1;4;Mexico;1968
25;Ethiopia;1;1;0;2;Mexico;1968
25;Norway;1;1;0;2;Mexico;1968
27;New Zealand;1;0;2;3;Mexico;1968
28;Tunisia;1;0;1;2;Mexico;1968
29;Pakistan;1;0;0;1;Mexico;1968
29;Venezuela;1;0;0;1;Mexico;1968
31;Cuba;0;4;0;4;Mexico;1968
32;Austria;0;2;2;4;Mexico;1968
33;Swiss;0;1;4;5;Mexico;1968
34;Mongolia;0;1;3;4;Mexico;1968
35;Brazil;0;1;2;3;Mexico;1968
36;Belgium;0;1;1;2;Mexico;1968
36;South Korea;0;1;1;2;Mexico;1968
36;Uganda;0;1;1;2;Mexico;1968
39;Cameroon;0;1;0;1;Mexico;1968
39;Jamaica;0;1;0;1;Mexico;1968
41;Argentina;0;0;2;2;Mexico;1968
42;Greece;0;0;1;1;Mexico;1968
42;India;0;0;1;1;Mexico;1968
42;Taiwan;0;0;1;1;Mexico;1968
1;UNITED STATES;36;26;28;90;Tokyo;1964
2;U.S.S.R.;31;31;36;98;Tokyo;1964
3;Japan;16;5;8;29;Tokyo;1964
4;Germany;10;22;18;50;Tokyo;1964
5;Italy;10;10;7;27;Tokyo;1964
6;Hungary;10;7;5;22;Tokyo;1964
7;Poland;6;6;10;22;Tokyo;1964
8;Australia;6;2;10;18;Tokyo;1964
9;Czechoslovakia;5;6;3;14;Tokyo;1964
10;Britain;4;13;2;19;Tokyo;1964
11;Bulgaria;3;5;2;10;Tokyo;1964
12;Finland;3;0;2;5;Tokyo;1964
12;New Zealand;3;0;2;5;Tokyo;1964
14;Romania;2;4;6;12;Tokyo;1964
15;The Netherlands;2;4;4;10;Tokyo;1964
16;Türkiye;2;3;1;6;Tokyo;1964
17;Sweden;2;2;4;8;Tokyo;1964
18;Denmark;2;1;3;6;Tokyo;1964
19;Yugoslavia;2;1;2;5;Tokyo;1964
20;Belgium;2;0;1;3;Tokyo;1964
21;France;1;7;5;13;Tokyo;1964
22;Canada;1;2;1;4;Tokyo;1964
22;Swiss;1;2;1;4;Tokyo;1964
24;Bahamas;1;0;0;1;Tokyo;1964
24;Ethiopia;1;0;0;1;Tokyo;1964
24;India;1;0;0;1;Tokyo;1964
27;South Korea;0;2;1;3;Tokyo;1964
28;Trinidad and Tobago;0;1;2;3;Tokyo;1964
29;Tunisia;0;1;1;2;Tokyo;1964
30;Argentina;0;1;0;1;Tokyo;1964
30;Cuba;0;1;0;1;Tokyo;1964
30;Pakistan;0;1;0;1;Tokyo;1964
30;Philippines;0;1;0;1;Tokyo;1964
34;Iran;0;0;2;2;Tokyo;1964
35;Brazil;0;0;1;1;Tokyo;1964
35;Ghana;0;0;1;1;Tokyo;1964
35;Ireland;0;0;1;1;Tokyo;1964
35;Kenya;0;0;1;1;Tokyo;1964
35;Mexico;0;0;1;1;Tokyo;1964
35;Nigeria;0;0;1;1;Tokyo;1964
35;Uruguay;0;0;1;1;Tokyo;1964
1;U.S.S.R.;43;29;31;103;Rome;1960
2;UNITED STATES;34;21;16;71;Rome;1960
3;Italy;13;10;13;36;Rome;1960
4;Germany;12;19;11;42;Rome;1960
5;Australia;8;8;6;22;Rome;1960
6;Türkiye;7;2;0;9;Rome;1960
7;Hungary;6;8;7;21;Rome;1960
8;Japan;4;7;7;18;Rome;1960
9;Poland;4;6;11;21;Rome;1960
10;Czechoslovakia;3;2;3;8;Rome;1960
11;Romania;3;1;6;10;Rome;1960
12;Britain;2;6;12;20;Rome;1960
13;Denmark;2;3;1;6;Rome;1960
14;New Zealand;2;0;1;3;Rome;1960
15;Bulgaria;1;3;3;7;Rome;1960
16;Sweden;1;2;3;6;Rome;1960
17;Finland;1;1;3;5;Rome;1960
18;Austria;1;1;0;2;Rome;1960
18;Yugoslavia;1;1;0;2;Rome;1960
20;Pakistan;1;0;1;2;Rome;1960
21;Ethiopia;1;0;0;1;Rome;1960
21;Greece;1;0;0;1;Rome;1960
21;Norway;1;0;0;1;Rome;1960
24;Swiss;0;3;3;6;Rome;1960
25;France;0;2;3;5;Rome;1960
26;Belgium;0;2;2;4;Rome;1960
27;Iran;0;1;3;4;Rome;1960
28;South Africa;0;1;2;3;Rome;1960
28;The Netherlands;0;1;2;3;Rome;1960
30;Argentina;0;1;1;2;Rome;1960
30;Egypt;0;1;1;2;Rome;1960
32;Canada;0;1;0;1;Rome;1960
32;Ghana;0;1;0;1;Rome;1960
32;India;0;1;0;1;Rome;1960
32;Morocco;0;1;0;1;Rome;1960
32;Portugal;0;1;0;1;Rome;1960
32;Singapore;0;1;0;1;Rome;1960
32;Taiwan;0;1;0;1;Rome;1960
39;Brazil;0;0;2;2;Rome;1960
39;West Indies;0;0;2;2;Rome;1960
41;Spain;0;0;1;1;Rome;1960
41;Iraq;0;0;1;1;Rome;1960
41;Mexico;0;0;1;1;Rome;1960
41;Venezuela;0;0;1;1;Rome;1960
1;U.S.S.R.;37;29;32;98;Melbourne;1956
2;UNITED STATES;33;25;17;75;Melbourne;1956
3;Australia;13;8;14;35;Melbourne;1956
4;Hungary;9;10;7;26;Melbourne;1956
5;Italy;8;8;9;25;Melbourne;1956
6;Sweden;8;5;6;19;Melbourne;1956
7;Germany;6;13;7;26;Melbourne;1956
8;Britain;6;7;11;24;Melbourne;1956
9;Romania;5;3;5;13;Melbourne;1956
10;Japan;4;10;5;19;Melbourne;1956
11;France;4;4;6;14;Melbourne;1956
12;Türkiye;3;2;2;7;Melbourne;1956
13;Finland;3;1;11;15;Melbourne;1956
14;Iran;2;2;1;5;Melbourne;1956
15;Canada;2;1;3;6;Melbourne;1956
16;New Zealand;2;0;0;2;Melbourne;1956
17;Poland;1;4;4;9;Melbourne;1956
18;Bulgaria;1;3;1;5;Melbourne;1956
19;Denmark;1;2;1;4;Melbourne;1956
20;Ireland;1;1;3;5;Melbourne;1956
21;Norway;1;0;2;3;Melbourne;1956
22;Mexico;1;0;1;2;Melbourne;1956
23;Brazil;1;0;0;1;Melbourne;1956
23;India;1;0;0;1;Melbourne;1956
25;Czechoslovakia;0;4;1;5;Melbourne;1956
26;Yugoslavia;0;3;0;3;Melbourne;1956
27;Chile;0;2;2;4;Melbourne;1956
28;Belgium;0;2;0;2;Melbourne;1956
29;Argentina;0;1;1;2;Melbourne;1956
29;South Korea;0;1;1;2;Melbourne;1956
31;Iceland;0;1;0;1;Melbourne;1956
31;Pakistan;0;1;0;1;Melbourne;1956
33;South Africa;0;0;4;4;Melbourne;1956
34;Austria;0;0;2;2;Melbourne;1956
35;Bahamas;0;0;1;1;Melbourne;1956
35;Greece;0;0;1;1;Melbourne;1956
35;Swiss;0;0;1;1;Melbourne;1956
35;Uruguay;0;0;1;1;Melbourne;1956
1;UNITED STATES;40;19;17;76;Helsinki;1952
2;U.S.S.R.;22;30;19;71;Helsinki;1952
3;Hungary;16;10;16;42;Helsinki;1952
4;Sweden;12;13;10;35;Helsinki;1952
5;Italy;8;9;4;21;Helsinki;1952
6;Czechoslovakia;7;3;3;13;Helsinki;1952
7;France;6;6;6;18;Helsinki;1952
8;Finland;6;3;13;22;Helsinki;1952
9;Australia;6;2;3;11;Helsinki;1952
10;Norway;3;2;0;5;Helsinki;1952
11;Swiss;2;6;6;14;Helsinki;1952
12;South Africa;2;4;4;10;Helsinki;1952
13;Jamaica;2;3;0;5;Helsinki;1952
14;Belgium;2;2;0;4;Helsinki;1952
15;Denmark;2;1;3;6;Helsinki;1952
16;Türkiye;2;0;1;3;Helsinki;1952
17;Japan;1;6;2;9;Helsinki;1952
18;Britain;1;2;8;11;Helsinki;1952
19;Argentina;1;2;2;5;Helsinki;1952
20;Poland;1;2;1;4;Helsinki;1952
21;Canada;1;2;0;3;Helsinki;1952
21;Yugoslavia;1;2;0;3;Helsinki;1952
23;Romania;1;1;2;4;Helsinki;1952
24;Brazil;1;0;2;3;Helsinki;1952
24;New Zealand;1;0;2;3;Helsinki;1952
26;India;1;0;1;2;Helsinki;1952
27;Luxembourg;1;0;0;1;Helsinki;1952
28;Germany;0;7;17;24;Helsinki;1952
29;The Netherlands;0;5;0;5;Helsinki;1952
30;Iran;0;3;4;7;Helsinki;1952
31;Chile;0;2;0;2;Helsinki;1952
32;Austria;0;1;1;2;Helsinki;1952
32;Lebanon;0;1;1;2;Helsinki;1952
34;Spain;0;1;0;1;Helsinki;1952
34;Ireland;0;1;0;1;Helsinki;1952
34;Mexico;0;1;0;1;Helsinki;1952
37;South Korea;0;0;2;2;Helsinki;1952
37;Trinidad and Tobago;0;0;2;2;Helsinki;1952
37;Uruguay;0;0;2;2;Helsinki;1952
40;Bulgaria;0;0;1;1;Helsinki;1952
40;Egypt;0;0;1;1;Helsinki;1952
40;Portugal;0;0;1;1;Helsinki;1952
40;Venezuela;0;0;1;1;Helsinki;1952
1;UNITED STATES;38;27;19;84;London;1948
2;Sweden;16;11;17;44;London;1948
3;France;10;6;13;29;London;1948
4;Hungary;10;5;12;27;London;1948
5;Italy;8;11;8;27;London;1948
6;Finland;8;7;5;20;London;1948
7;Türkiye;6;4;2;12;London;1948
8;Czechoslovakia;6;2;3;11;London;1948
9;Swiss;5;10;5;20;London;1948
10;Denmark;5;7;8;20;London;1948
11;The Netherlands;5;2;9;16;London;1948
12;Britain;3;14;6;23;London;1948
13;Argentina;3;3;1;7;London;1948
14;Australia;2;6;5;13;London;1948
15;Belgium;2;2;3;7;London;1948
16;Egypt;2;2;1;5;London;1948
17;Mexico;2;1;2;5;London;1948
18;South Africa;2;1;1;4;London;1948
19;Norway;1;3;3;7;London;1948
20;Jamaica;1;2;0;3;London;1948
21;Austria;1;0;3;4;London;1948
22;India;1;0;0;1;London;1948
22;Peru;1;0;0;1;London;1948
24;Yugoslavia;0;2;0;2;London;1948
25;Canada;0;1;2;3;London;1948
26;Portugal;0;1;1;2;London;1948
26;Uruguay;0;1;1;2;London;1948
28;Cuba;0;1;0;1;London;1948
28;Spain;0;1;0;1;London;1948
28;Sri Lanka;0;1;0;1;London;1948
28;Trinidad and Tobago;0;1;0;1;London;1948
32;South Korea;0;0;2;2;London;1948
32;Panama;0;0;2;2;London;1948
34;Brazil;0;0;1;1;London;1948
34;Iran;0;0;1;1;London;1948
34;Poland;0;0;1;1;London;1948
34;Porto Rico;0;0;1;1;London;1948
1;Germany;33;26;30;89;Berlin;1936
2;UNITED STATES;24;20;12;56;Berlin;1936
3;Hungary;10;1;5;16;Berlin;1936
4;Italy;8;9;5;22;Berlin;1936
5;Finland;7;6;6;19;Berlin;1936
5;France;7;6;6;19;Berlin;1936
7;Sweden;6;5;9;20;Berlin;1936
8;Japan;6;4;8;18;Berlin;1936
9;The Netherlands;6;4;7;17;Berlin;1936
10;Britain;4;7;3;14;Berlin;1936
11;Austria;4;6;3;13;Berlin;1936
12;Czechoslovakia;3;5;0;8;Berlin;1936
13;Argentina;2;2;3;7;Berlin;1936
13;Estonia;2;2;3;7;Berlin;1936
15;Egypt;2;1;2;5;Berlin;1936
16;Swiss;1;9;5;15;Berlin;1936
17;Canada;1;3;5;9;Berlin;1936
18;Norway;1;3;2;6;Berlin;1936
19;Türkiye;1;0;1;2;Berlin;1936
20;India;1;0;0;1;Berlin;1936
20;New Zealand;1;0;0;1;Berlin;1936
22;Poland;0;3;3;6;Berlin;1936
23;Denmark;0;2;3;5;Berlin;1936
24;Latvia;0;1;1;2;Berlin;1936
25;South Africa;0;1;0;1;Berlin;1936
25;Romania;0;1;0;1;Berlin;1936
25;Yugoslavia;0;1;0;1;Berlin;1936
28;Mexico;0;0;3;3;Berlin;1936
29;Belgium;0;0;2;2;Berlin;1936
30;Australia;0;0;1;1;Berlin;1936
30;Philippines;0;0;1;1;Berlin;1936
30;Portugal;0;0;1;1;Berlin;1936
1;UNITED STATES;41;32;29;102;Los Angeles;1932
2;Italy;13;11;12;36;Los Angeles;1932
3;France;9;6;4;19;Los Angeles;1932
4;Sweden;9;5;9;23;Los Angeles;1932
5;Japan;7;7;4;18;Los Angeles;1932
6;Hungary;6;4;5;15;Los Angeles;1932
7;Finland;5;8;12;25;Los Angeles;1932
8;Britain;4;7;5;16;Los Angeles;1932
9;Germany;3;12;5;20;Los Angeles;1932
10;Australia;3;1;1;5;Los Angeles;1932
11;Argentina;3;1;0;4;Los Angeles;1932
12;Canada;2;5;8;15;Los Angeles;1932
13;The Netherlands;2;5;0;7;Los Angeles;1932
14;Poland;2;1;4;7;Los Angeles;1932
15;South Africa;2;0;3;5;Los Angeles;1932
16;Ireland;2;0;0;2;Los Angeles;1932
17;Czechoslovakia;1;2;1;4;Los Angeles;1932
18;Austria;1;1;3;5;Los Angeles;1932
19;India;1;0;0;1;Los Angeles;1932
20;Denmark;0;3;3;6;Los Angeles;1932
21;Mexico;0;2;0;2;Los Angeles;1932
22;Latvia;0;1;0;1;Los Angeles;1932
22;New Zealand;0;1;0;1;Los Angeles;1932
22;Swiss;0;1;0;1;Los Angeles;1932
25;Philippines;0;0;3;3;Los Angeles;1932
26;Spain;0;0;1;1;Los Angeles;1932
26;Portugal;0;0;1;1;Los Angeles;1932
26;Uruguay;0;0;1;1;Los Angeles;1932
1;UNITED STATES;22;18;16;56;Amsterdam;1928
2;Germany;10;7;14;31;Amsterdam;1928
3;Finland;8;8;9;25;Amsterdam;1928
4;Sweden;7;6;12;25;Amsterdam;1928
5;Italy;7;5;7;19;Amsterdam;1928
6;Swiss;7;4;4;15;Amsterdam;1928
7;France;6;10;5;21;Amsterdam;1928
8;The Netherlands;6;9;4;19;Amsterdam;1928
9;Hungary;4;5;0;9;Amsterdam;1928
10;Canada;4;4;7;15;Amsterdam;1928
11;Britain;3;10;7;20;Amsterdam;1928
12;Argentina;3;3;1;7;Amsterdam;1928
13;Denmark;3;1;2;6;Amsterdam;1928
14;Czechoslovakia;2;5;2;9;Amsterdam;1928
15;Japan;2;2;1;5;Amsterdam;1928
16;Estonia;2;1;2;5;Amsterdam;1928
17;Egypt;2;1;1;4;Amsterdam;1928
18;Austria;2;0;1;3;Amsterdam;1928
19;Australia;1;2;1;4;Amsterdam;1928
19;Norway;1;2;1;4;Amsterdam;1928
21;Poland;1;1;3;5;Amsterdam;1928
21;Yugoslavia;1;1;3;5;Amsterdam;1928
23;South Africa;1;0;2;3;Amsterdam;1928
24;Spain;1;0;0;1;Amsterdam;1928
24;India;1;0;0;1;Amsterdam;1928
24;Ireland;1;0;0;1;Amsterdam;1928
24;New Zealand;1;0;0;1;Amsterdam;1928
24;Uruguay;1;0;0;1;Amsterdam;1928
29;Belgium;0;1;2;3;Amsterdam;1928
30;Chile;0;1;0;1;Amsterdam;1928
30;Haiti;0;1;0;1;Amsterdam;1928
32;Philippines;0;0;1;1;Amsterdam;1928
32;Portugal;0;0;1;1;Amsterdam;1928
1;UNITED STATES;45;27;27;99;Paris;1924
2;Finland;14;13;10;37;Paris;1924
3;France;13;15;10;38;Paris;1924
4;Britain;9;13;12;34;Paris;1924
5;Italy;8;3;5;16;Paris;1924
6;Swiss;7;8;10;25;Paris;1924
7;Norway;5;2;3;10;Paris;1924
8;Sweden;4;13;12;29;Paris;1924
9;The Netherlands;4;1;5;10;Paris;1924
10;Belgium;3;7;3;13;Paris;1924
11;Australia;3;1;2;6;Paris;1924
12;Denmark;2;5;2;9;Paris;1924
13;Hungary;2;3;4;9;Paris;1924
14;Yugoslavia;2;0;0;2;Paris;1924
15;Czechoslovakia;1;4;5;10;Paris;1924
16;Argentina;1;3;2;6;Paris;1924
17;Estonia;1;1;4;6;Paris;1924
18;South Africa;1;1;1;3;Paris;1924
19;Uruguay;1;0;0;1;Paris;1924
20;Austria;0;3;1;4;Paris;1924
20;Canada;0;3;1;4;Paris;1924
22;Poland;0;1;1;2;Paris;1924
23;Haiti;0;0;1;1;Paris;1924
23;Japan;0;0;1;1;Paris;1924
23;New Zealand;0;0;1;1;Paris;1924
23;Portugal;0;0;1;1;Paris;1924
23;Romania;0;0;1;1;Paris;1924
1;UNITED STATES;41;27;27;95;Antwerp;1920
2;Sweden;19;21;24;64;Antwerp;1920
3;Britain;15;15;13;43;Antwerp;1920
4;Finland;15;10;9;34;Antwerp;1920
5;Belgium;14;11;11;36;Antwerp;1920
6;Norway;13;9;9;31;Antwerp;1920
7;Italy;13;5;5;23;Antwerp;1920
8;France;9;19;13;41;Antwerp;1920
9;The Netherlands;4;2;5;11;Antwerp;1920
10;Denmark;3;9;1;13;Antwerp;1920
11;South Africa;3;4;3;10;Antwerp;1920
12;Canada;3;3;3;9;Antwerp;1920
13;Swiss;2;2;7;11;Antwerp;1920
14;Estonia;1;2;0;3;Antwerp;1920
15;Brazil;1;1;1;3;Antwerp;1920
16;Australia;0;2;1;3;Antwerp;1920
17;Spain;0;2;0;2;Antwerp;1920
17;Japan;0;2;0;2;Antwerp;1920
19;Greece;0;1;0;1;Antwerp;1920
19;Luxembourg;0;1;0;1;Antwerp;1920
21;Czechoslovakia;0;0;2;2;Antwerp;1920
22;New Zealand;0;0;1;1;Antwerp;1920
1;UNITED STATES;25;18;20;63;Stockholm;1912
2;Sweden;23;24;17;64;Stockholm;1912
3;Britain;10;15;16;41;Stockholm;1912
4;Finland;9;8;9;26;Stockholm;1912
5;France;7;4;3;14;Stockholm;1912
6;Germany;5;13;7;25;Stockholm;1912
7;South Africa;4;2;0;6;Stockholm;1912
8;Norway;3;2;4;9;Stockholm;1912
9;Hungary;3;2;3;8;Stockholm;1912
10;Canada;3;2;2;7;Stockholm;1912
11;Italy;3;1;2;6;Stockholm;1912
12;Australasia;2;2;2;6;Stockholm;1912
13;Belgium;2;1;3;6;Stockholm;1912
14;Denmark;1;6;5;12;Stockholm;1912
15;Greece;1;0;1;2;Stockholm;1912
16;Russia;0;2;3;5;Stockholm;1912
17;Austria;0;2;2;4;Stockholm;1912
18;The Netherlands;0;0;3;3;Stockholm;1912
19;New Zealand;0;0;1;1;Stockholm;1912
1;Britain;51;44;34;129;London;1908
2;UNITED STATES;22;12;12;46;London;1908
3;Sweden;8;6;11;25;London;1908
4;France;4;5;9;18;London;1908
5;Germany;3;5;5;13;London;1908
6;Hungary;3;4;2;9;London;1908
7;Canada;2;3;10;15;London;1908
8;Norway;2;3;3;8;London;1908
9;Italy;2;2;0;4;London;1908
10;Belgium;1;5;2;8;London;1908
11;Australasia;1;2;2;5;London;1908
12;Finland;1;1;3;5;London;1908
13;South Africa;1;1;0;2;London;1908
14;Guyana;1;0;0;1;London;1908
15;Greece;0;3;0;3;London;1908
16;Denmark;0;2;3;5;London;1908
17;Ireland;0;2;0;2;London;1908
17;Russia;0;2;0;2;London;1908
19;Bohemia;0;0;2;2;London;1908
19;The Netherlands;0;0;2;2;London;1908
21;Austria;0;0;1;1;London;1908
1;France;15;9;16;40;Athens;1906
2;UNITED STATES;12;6;6;24;Athens;1906
3;Greece;8;14;12;34;Athens;1906
4;Britain;8;10;5;23;Athens;1906
5;Italy;7;6;3;16;Athens;1906
6;Swiss;5;6;4;15;Athens;1906
7;Germany;4;6;5;15;Athens;1906
8;Norway;4;2;1;7;Athens;1906
9;Austria;3;3;2;8;Athens;1906
10;Sweden;2;5;7;14;Athens;1906
11;Hungary;2;5;3;10;Athens;1906
12;Belgium;2;2;3;7;Athens;1906
13;Denmark;2;2;1;5;Athens;1906
14;Finland;2;0;1;3;Athens;1906
15;Canada;1;1;0;2;Athens;1906
16;Australia;0;1;2;3;Athens;1906
16;The Netherlands;0;1;2;3;Athens;1906
18;Bohemia;0;0;2;2;Athens;1906
19;Australasia;0;0;1;1;Athens;1906
19;Ottoman Empire;0;0;1;1;Athens;1906
1;UNITED STATES;80;82;79;241;Saint Louis;1904
2;Germany;4;4;5;13;Saint Louis;1904
3;Cuba;4;0;0;4;Saint Louis;1904
4;Canada;3;1;0;4;Saint Louis;1904
5;Hungary;2;1;1;4;Saint Louis;1904
6;Britain;1;1;0;2;Saint Louis;1904
7;Greece;1;0;1;2;Saint Louis;1904
7;Swiss;1;0;1;2;Saint Louis;1904
9;France;0;1;0;1;Saint Louis;1904
10;Austria;0;0;1;1;Saint Louis;1904
1;France;25;38;32;95;Paris;1900
2;UNITED STATES;19;15;15;49;Paris;1900
3;Britain;16;5;9;30;Paris;1900
4;Swiss;6;2;1;9;Paris;1900
5;Belgium;5;5;5;15;Paris;1900
6;Germany;4;2;2;8;Paris;1900
7;Italy;2;2;0;4;Paris;1900
8;Australia;2;0;3;5;Paris;1900
9;Denmark;1;3;2;6;Paris;1900
10;Hungary;1;2;2;5;Paris;1900
11;The Netherlands;1;1;3;5;Paris;1900
12;Cuba;1;1;0;2;Paris;1900
12;International;1;1;0;2;Paris;1900
14;Canada;1;0;1;2;Paris;1900
15;Austria;0;3;3;6;Paris;1900
16;Norway;0;2;3;5;Paris;1900
17;India;0;2;0;2;Paris;1900
18;Bohemia;0;1;2;3;Paris;1900
19;Mexico;0;0;1;1;Paris;1900
19;Sweden;0;0;1;1;Paris;1900
1;UNITED STATES;11;7;2;20;Athens;1896
2;Greece;10;18;19;47;Athens;1896
3;Germany;7;5;2;14;Athens;1896
4;France;5;4;2;11;Athens;1896
5;Britain;2;3;2;7;Athens;1896
6;Hungary;2;1;3;6;Athens;1896
7;Austria;2;1;2;5;Athens;1896
8;Australia;2;0;1;3;Athens;1896
9;Denmark;1;2;3;6;Athens;1896
10;Swiss;1;2;0;3;Athens;1896
